{
    "name": "A",
    "width": 24,
    "height": 15,
    "tiles": [
        [16, 17, 16, 16, 16, 16, 16, 16, 17, 16, 16, 16, 16, 16, 16, 16, 16, 16, 16, 16, 16, 16, 16, 16],
        [16, 16, 16, 16, 17, 16, 16, 16, 16, 15, 16, 16, 16, 15, 16, 16, 16, 17, 16, 16, 16, 17, 16, 16],
        [16, 16, 16, 16, 16, 16, 16, 16, 16, 16, 16, 16, 16, 16, 16, 16, 16, 16, 16, 16, 15, 16, 16, 16],
        [1, 1, 1, 1, 1, 1, 1, 1, 1, 1, 1, 1, 1, 1, 16, 16, 16, 1, 1, 1, 16, 16, 16, 16],
        [1, 1, 1, 1, 1, 1, 1, 1, 1, 1, 1, 1, 1, 1, 1, 16, 16, 1, 1, 16, 17, 16, 16, 16],
        [16, 16, 16, 16, 15, 1, 1, 15, 15, 15, 15, 15, 1, 1, 1, 1, 1, 1, 16, 16, 16, 16, 15, 16],
        [16, 16, 16, 16, 16, 1, 1, 15, 17, 16, 16, 16, 15, 1, 1, 1, 1, 16, 16, 17, 16, 16, 16, 16],
        [16, 15, 16, 15, 16, 1, 1, 15, 16, 16, 16, 16, 16, 15, 1, 1, 1, 1, 16, 16, 16, 15, 16, 16],
        [16, 16, 16, 16, 16, 1, 1, 15, 16, 17, 16, 16, 17, 16, 15, 1, 1, 1, 1, 16, 16, 16, 16, 17],
        [16, 15, 16, 15, 16, 1, 1, 15, 16, 16, 16, 16, 16, 16, 16, 15, 1, 1, 1, 16, 16, 17, 16, 16],
        [16, 16, 16, 16, 16, 1, 1, 1, 15, 15, 15, 15, 15, 15, 15, 15, 15, 1, 1, 16, 16, 16, 16, 16],
        [16, 17, 16, 16, 16, 1, 1, 1, 1, 1, 1, 1, 1, 1, 1, 1, 1, 1, 1, 1, 1, 1, 1, 1],
        [16, 16, 16, 16, 16, 16, 1, 1, 1, 1, 1, 1, 1, 1, 1, 1, 1, 1, 1, 1, 1, 1, 1, 1],
        [16, 16, 17, 16, 16, 17, 16, 16, 16, 16, 16, 16, 16, 16, 16, 16, 16, 16, 16, 16, 16, 16, 16, 16],
        [16, 16, 16, 16, 16, 16, 16, 16, 16, 16, 16, 16, 17, 16, 16, 16, 16, 16, 16, 16, 17, 16, 16, 16]
    ],
    "dots": {
        "17": 16,
        "15": 16
    }
}
